BigHornSheep	Artiodactyla
Okapi	Artiodactyla
Giraffe	Artiodactyla
Gazelle	Artiodactyla
Springbok	Artiodactyla
Urial	Artiodactyla
WartyPig	Artiodactyla
BushDog	Carnivora
Lion	Carnivora
BlackBear	Carnivora
PolarBear	Carnivora
SpectacledBear	Carnivora
Hyena	Carnivora
Colobus	Primates
BlackLemur	Primates
Chimp	Primates
Callimicos	Primates
Baboon	Primates
RingTailedLemur	Primates
Orangutan	Primates
Gorilla	Primates
Saki	Primates
